151111111111111
101111100011011
100000001000001
110101111111101
110101000000001
100100011111101
101001000000101
101011111101101
101001000001101
101101011100006
100001010001011
110101010101001
110101000100011
100000010101001
111111111111111